24 24
11 11
1 11
22 1
22 22

0 0 0 0 0 0 0 0 0 0 0 0 0 0 0 0 0 0 0 0 0 0 0 0 
0 1 1 1 1 1 1 1 1 1 1 0 0 1 1 1 1 1 1 1 1 1 1 0 
0 1 1 0 0 0 1 0 0 0 1 0 0 1 0 0 0 0 0 0 0 0 1 0 
0 1 1 0 0 0 1 0 0 0 1 0 0 1 1 1 0 0 0 0 1 1 1 0 
0 1 1 0 0 0 1 0 0 0 1 0 0 1 1 1 0 0 0 0 1 1 1 0 
0 1 1 0 0 0 1 0 0 0 1 0 0 1 1 1 0 0 0 0 1 1 1 0 
0 1 1 0 0 0 1 0 0 0 1 0 0 1 1 1 0 0 0 0 1 1 1 0 
0 1 1 0 0 0 1 0 0 0 1 0 0 1 1 1 0 0 0 0 1 1 1 0 
0 1 1 0 0 0 1 0 0 0 1 0 0 1 1 1 0 0 0 0 1 1 1 0 
0 1 1 0 0 0 1 0 0 0 1 0 0 1 1 1 0 0 0 0 1 1 1 0 
0 1 1 0 0 0 1 0 0 0 1 0 0 1 1 1 0 0 0 0 1 1 1 0 
0 1 1 0 0 0 0 0 0 0 1 1 1 1 1 1 0 0 0 0 1 1 1 0 
0 1 1 0 0 0 0 0 0 0 1 0 0 1 1 1 0 0 0 0 1 1 1 0 
0 1 1 0 0 0 1 0 0 0 1 0 0 1 1 1 0 0 0 0 1 1 1 0 
0 1 1 0 0 0 1 0 0 0 1 0 0 1 1 1 0 0 0 0 1 1 1 0 
0 1 1 0 0 0 1 0 0 0 1 0 0 1 1 1 0 0 0 0 1 1 1 0 
0 1 1 0 0 0 1 0 0 0 1 0 0 1 1 1 0 0 0 0 1 1 1 0 
0 1 1 0 0 0 1 0 0 0 1 0 0 1 1 1 0 0 0 0 1 1 1 0 
0 1 1 0 0 0 1 0 0 0 1 0 0 1 1 1 0 0 0 0 1 1 1 0 
0 1 1 0 0 0 1 0 0 0 1 0 0 1 1 1 0 0 0 0 1 1 1 0 
0 1 1 0 0 0 1 0 0 0 1 0 0 1 1 1 0 0 0 0 1 1 1 0 
0 1 1 0 0 0 1 0 0 0 1 0 0 1 0 0 0 0 0 0 0 0 1 0 
0 1 1 1 1 1 1 1 1 1 1 0 0 1 1 1 1 1 1 1 1 1 1 0 
0 0 0 0 0 0 0 0 0 0 0 0 0 0 0 0 0 0 0 0 0 0 0 0 
